field-1.png
140
130
0 0 0 0 0 0 0 0 0 0 0
0 0 0 0 0 0 0 0 0 0 0
0 0 0 0 0 0 0 0 0 0 0
D D D D D D D D D D D
R R R R R R R R R R R
Y Y Y Y Y Y Y Y Y Y Y
B B B B B B B B B B B
M M M M M M M M M M M
G G G G G G G G G G G
D D D D D D D D D D D
