field-2.png
130
150
0 0 0 0 0 0 0 0 0 0 0
0 0 0 0 0 0 0 0 0 0 0
P 0 0 0 0 0 0 0 0 0 0
P C 0 0 0 0 0 0 0 0 0
P C G 0 0 0 0 0 0 0 0
P C G B 0 0 0 0 0 0 0
P C G B R 0 0 0 0 0 0
P C G B R P 0 0 0 0 0
P C G B R P C 0 0 0 0
P C G B R P C G 0 0 0
P C G B R P C G B 0 0
P C G B R P C G B R 0
D D D D D D D D D D P